2 2 2 2 2 2 8 8 8 8 8 8 8 8 1 1 1 1 1 1
2 5 5 5 5 5 8 3 3 3 3 3 3 8 4 4 1 4 4 1
2 5 5 2 5 5 8 3 3 8 8 3 3 8 4 4 4 4 4 1
2 5 2 5 5 5 8 3 3 3 3 3 3 8 4 4 4 1 4 1
2 5 5 5 5 5 8 3 8 3 3 8 3 8 4 1 4 4 4 1
2 5 5 5 2 5 3 3 3 3 3 3 3 3 4 4 4 4 4 1
2 5 5 5 5 5 3 3 3 3 3 3 3 3 4 1 4 4 4 1
2 5 5 5 2 5 7 3 7 3 3 7 3 7 4 4 4 4 4 1
2 5 5 5 5 5 7 3 3 3 3 3 3 7 4 4 1 1 4 1
2 5 2 5 5 5 7 7 3 3 3 3 7 7 4 4 4 4 4 1
2 5 5 5 2 5 7 3 3 7 7 3 3 7 4 4 1 4 4 1
2 5 5 5 5 5 7 3 3 3 3 3 3 7 1 4 4 4 4 1
2 2 5 5 5 5 7 7 3 3 3 3 7 7 4 4 4 4 1 1
2 5 5 5 6 6 6 6 6 0 0 6 6 6 6 6 4 4 4 1 
2 5 5 0 0 0 0 0 0 0 0 0 0 0 0 0 0 4 4 1
2 5 0 0 0 0 6 6 0 0 0 0 6 6 0 0 0 0 4 1
6 6 0 0 6 0 0 0 0 0 0 0 0 0 0 6 0 0 6 6
6 0 0 0 6 0 0 6 0 0 0 0 6 0 0 6 0 0 0 6
6 0 0 0 0 0 0 0 0 0 0 0 0 0 0 0 0 0 0 6
6 6 6 6 6 6 6 6 6 6 6 6 6 6 6 6 6 6 6 6